NO ./textures/redstone.xpm
SO ./textures/redstone.xpm
WE ./textures/redstone.xpm
EA ./textures/greystone.xpm

F 80,80,80
C 46,60,108


        111111111
1111111 11000001
1000001111000001
1001000000000001
1000E00111111111
1000000001
10001100001
1000011001
1000000001
1011110011
11111111
