NO ./textures/text_n.xpm
SO ./textures/text_s.xpm
WE ./textures/text_w.xpm
EA ./textures/text_e.xpm

F 80,80,80
C 46,60,108


        11111111111
1111111 10000000111
100000111100E001
1001000000000001
111111111111111
