1111111111111
1000000000001
1000P00000011
1000100000001
1111100000011
11E0111000011
100C000000001
1111111111111