1111111111111
1P000C000C001
1011111111101
100000E100001
1111111111111
